#############.######
####.########.######
####.########.######
####.########.######
###..########.######
###.####......######
###.####.###########
###.####.###########
###.####.###########
###.####......######
###.#########.######
###.#########.######
###...........######
####################
####################